[
    {
        "Stage": 0,
        "Id": 0,
        "Size": { "Width": 960, "Height": 540 },
        "StationaryMap": [
            [4, 4, 4, 6, 2, 1, 1, 1, 1, 1, 1, 3, 5, 4, 4, 4, 4, 4, 4, 4, 4, 6, 8, 7, 7, 7, 7, 7, 7, 7, 7, 7, 7, 7, 9, 5, 4, 4, 4, 4, 4, 4, 4, 6, 5, 4, 4, 4, 4, 4, 4, 4, 4, 4, 6, 5, 4, 4, 4, 4],
            [4, 4, 4, 6, 5, 4, 4, 4, 4, 4, 4, 6, 5, 4, 4, 4, 4, 4, 4, 4, 4, 6, 2, 1, 1, 1, 1, 1, 1, 1, 1, 1, 1, 1, 3, 5, 4, 4, 4, 4, 4, 4, 4, 6, 5, 4, 4, 4, 4, 4, 4, 4, 4, 4, 6, 5, 4, 4, 4, 4],
            [4, 4, 4, 6, 8, 7, 7, 7, 7, 7, 7, 9, 5, 4, 4, 4, 4, 4, 4, 4, 4, 6, 5, 4, 4, 4, 4, 4, 4, 4, 4, 4, 4, 4, 6, 5, 4, 4, 4, 4, 4, 4, 4, 6, 5, 4, 4, 4, 15, 1, 1, 1, 1, 1, 3, 2, 1, 1, 1, 1],
            [4, 4, 4, 6, 5, 4, 4, 4, 4, 4, 4, 6, 5, 4, 4, 4, 4, 4, 4, 4, 4, 6, 5, 4, 4, 4, 4, 4, 4, 4, 4, 4, 4, 4, 6, 5, 4, 4, 15, 1, 1, 1, 1, 3, 2, 1, 1, 1, 3, 0, 0, 0, 0, 0, 0, 0, 0, 0, 0, 0],
            [4, 4, 4, 6, 5, 4, 4, 4, 4, 4, 4, 6, 2, 1, 1, 1, 1, 1, 1, 1, 1, 3, 5, 4, 4, 4, 4, 4, 4, 4, 4, 4, 4, 4, 6, 5, 4, 4, 6, 0, 0, 0, 0, 0, 0, 0, 0, 0, 0, 0, 0, 0, 0, 0, 0, 0, 0, 0, 0, 0],
            [4, 4, 4, 6, 5, 4, 4, 4, 4, 4, 4, 6, 8, 7, 7, 7, 7, 7, 7, 7, 7, 9, 5, 4, 4, 4, 4, 4, 4, 4, 4, 15, 1, 1, 3, 2, 1, 1, 3, 0, 0, 0, 0, 0, 0, 0, 0, 0, 0, 0, 0, 0, 0, 0, 0, 0, 0, 0, 0, 0],
            [4, 4, 4, 6, 5, 4, 4, 4, 4, 4, 4, 6, 5, 4, 4, 4, 4, 4, 4, 4, 4, 6, 5, 4, 4, 4, 4, 15, 1, 1, 1, 3, 0, 0, 0, 0, 0, 0, 0, 0, 0, 0, 0, 0, 0, 0, 0, 0, 0, 0, 0, 0, 0, 0, 0, 0, 0, 0, 0, 0],
            [4, 4, 4, 6, 5, 4, 4, 4, 4, 4, 4, 6, 5, 4, 4, 4, 4, 4, 4, 4, 4, 6, 5, 4, 4, 4, 4, 6, 0, 0, 0, 0, 0, 0, 0, 0, 0, 0, 0, 0, 0, 0, 0, 0, 0, 0, 0, 0, 0, 0, 0, 0, 0, 0, 0, 0, 0, 0, 0, 0],
            [4, 4, 4, 6, 5, 4, 4, 4, 4, 4, 4, 6, 5, 4, 4, 15, 1, 1, 1, 1, 1, 3, 2, 1, 1, 1, 1, 3, 0, 0, 0, 0, 0, 0, 0, 0, 0, 0, 0, 0, 0, 0, 0, 0, 0, 0, 0, 0, 0, 0, 0, 0, 0, 0, 0, 0, 0, 0, 0, 0],
            [4, 4, 4, 6, 5, 4, 4, 4, 15, 1, 1, 3, 2, 1, 1, 3, 0, 0, 0, 0, 0, 0, 0, 0, 0, 0, 0, 0, 0, 0, 0, 0, 0, 0, 0, 0, 0, 0, 0, 0, 0, 0, 0, 0, 0, 0, 0, 0, 0, 0, 0, 0, 0, 0, 0, 0, 0, 0, 0, 0],
            [4, 4, 4, 6, 5, 4, 4, 4, 6, 0, 0, 0, 0, 0, 0, 0, 0, 0, 0, 0, 0, 0, 0, 0, 0, 0, 0, 0, 0, 0, 0, 0, 0, 0, 0, 0, 0, 0, 0, 0, 0, 0, 0, 0, 0, 0, 0, 0, 0, 0, 0, 0, 0, 0, 0, 0, 0, 0, 0, 0],
            [1, 1, 1, 3, 2, 1, 1, 1, 3, 0, 0, 0, 0, 0, 0, 0, 0, 0, 0, 0, 0, 0, 0, 0, 0, 0, 0, 0, 0, 0, 0, 0, 0, 0, 0, 0, 0, 0, 0, 0, 0, 0, 0, 0, 0, 0, 0, 0, 0, 0, 0, 0, 0, 0, 0, 0, 0, 0, 0, 0],
            [0, 0, 0, 0, 0, 0, 0, 0, 0, 0, 0, 0, 0, 0, 0, 0, 0, 0, 0, 0, 0, 0, 0, 0, 0, 0, 0, 0, 0, 0, 0, 0, 0, 0, 0, 0, 0, 0, 0, 0, 0, 0, 0, 0, 0, 0, 0, 0, 0, 0, 0, 0, 0, 0, 0, 0, 0, 0, 0, 0],
            [0, 0, 0, 0, 0, 0, 0, 0, 0, 0, 0, 0, 0, 0, 0, 0, 0, 0, 0, 0, 0, 0, 0, 0, 0, 0, 0, 0, 0, 0, 0, 0, 0, 0, 0, 0, 0, 0, 0, 0, 0, 0, 0, 0, 0, 0, 0, 0, 11, 10, 12, 8, 7, 7, 7, 9, 8, 7, 7, 7],
            [0, 0, 0, 0, 0, 0, 0, 0, 0, 0, 0, 0, 0, 0, 0, 0, 0, 0, 0, 0, 0, 0, 0, 0, 0, 0, 0, 0, 0, 0, 0, 0, 0, 0, 0, 0, 0, 0, 0, 0, 0, 0, 0, 0, 0, 0, 0, 0, 0, 0, 18, 5, 4, 4, 4, 6, 5, 4, 4, 4],
            [0, 0, 0, 0, 0, 0, 0, 0, 0, 0, 0, 0, 0, 0, 0, 0, 0, 0, 0, 0, 0, 0, 0, 0, 0, 0, 0, 0, 0, 0, 0, 0, 0, 0, 0, 0, 0, 0, 0, 0, 0, 0, 0, 0, 0, 0, 0, 0, 0, 0, 18, 5, 4, 4, 4, 6, 5, 4, 4, 4],
            [0, 0, 0, 0, 0, 0, 0, 0, 0, 0, 0, 0, 0, 0, 0, 0, 0, 0, 0, 0, 0, 0, 0, 0, 0, 0, 0, 0, 0, 0, 0, 0, 0, 0, 0, 0, 0, 0, 0, 0, 0, 0, 0, 0, 0, 0, 0, 0, 0, 0, 18, 5, 4, 15, 1, 3, 2, 1, 16, 4],
            [0, 0, 0, 0, 0, 0, 0, 0, 0, 0, 0, 0, 0, 0, 0, 0, 0, 0, 0, 0, 0, 0, 0, 0, 0, 0, 0, 0, 0, 0, 0, 0, 0, 0, 0, 0, 0, 0, 0, 11, 10, 10, 10, 10, 12, 0, 0, 0, 0, 0, 18, 5, 4, 6, 0, 0, 0, 0, 5, 4],
            [0, 0, 0, 0, 0, 0, 0, 0, 0, 0, 0, 0, 0, 0, 0, 0, 0, 0, 0, 0, 0, 0, 0, 0, 0, 0, 0, 0, 0, 0, 0, 0, 0, 0, 0, 0, 20, 20, 0, 0, 0, 0, 0, 0, 0, 0, 0, 0, 0, 0, 18, 5, 4, 6, 0, 0, 0, 0, 5, 4],
            [0, 0, 0, 0, 0, 0, 0, 0, 0, 0, 0, 0, 0, 0, 0, 0, 0, 0, 0, 0, 0, 0, 0, 0, 0, 0, 0, 0, 0, 0, 0, 0, 0, 0, 0, 0, 11, 12, 0, 0, 0, 0, 0, 0, 0, 0, 0, 0, 0, 0, 18, 5, 4, 6, 11, 10, 10, 12, 5, 4],
            [0, 0, 0, 0, 0, 0, 0, 0, 0, 0, 0, 0, 0, 0, 0, 0, 0, 0, 0, 0, 0, 0, 0, 0, 0, 0, 0, 0, 0, 0, 0, 0, 0, 0, 0, 0, 0, 0, 0, 0, 0, 0, 0, 0, 0, 0, 0, 0, 0, 0, 18, 5, 4, 6, 0, 0, 0, 0, 5, 4],
            [0, 0, 0, 0, 0, 0, 0, 0, 0, 0, 0, 0, 0, 0, 0, 0, 0, 0, 0, 0, 0, 0, 0, 0, 0, 0, 0, 0, 0, 11, 10, 10, 10, 10, 12, 0, 0, 0, 0, 0, 0, 0, 0, 0, 0, 0, 0, 0, 0, 0, 18, 5, 4, 6, 0, 0, 0, 0, 5, 4],
            [0, 0, 0, 0, 0, 0, 0, 0, 0, 0, 0, 0, 0, 0, 0, 0, 0, 0, 0, 0, 0, 0, 0, 0, 0, 0, 0, 0, 0, 0, 0, 0, 0, 0, 0, 0, 0, 0, 0, 0, 0, 0, 0, 0, 0, 0, 0, 0, 0, 0, 18, 5, 4, 6, 11, 10, 10, 12, 5, 4],
            [0, 0, 0, 0, 0, 0, 0, 0, 0, 0, 0, 0, 0, 0, 0, 0, 0, 0, 0, 0, 0, 0, 0, 0, 0, 0, 0, 0, 0, 0, 0, 0, 0, 0, 0, 0, 0, 0, 0, 0, 0, 0, 0, 0, 0, 0, 0, 0, 0, 0, 18, 5, 4, 6, 0, 0, 0, 0, 5, 4],
            [7, 7, 9, 8, 7, 9, 0, 0, 0, 0, 0, 0, 0, 0, 0, 0, 0, 0, 0, 0, 11, 10, 10, 10, 10, 12, 0, 0, 0, 0, 0, 0, 0, 0, 0, 0, 0, 0, 0, 0, 0, 0, 0, 0, 0, 0, 0, 0, 0, 0, 18, 5, 4, 6, 0, 0, 0, 0, 5, 4],
            [4, 4, 6, 5, 4, 6, 0, 0, 0, 0, 0, 0, 0, 0, 0, 0, 0, 0, 0, 0, 0, 0, 0, 0, 0, 0, 0, 0, 0, 0, 0, 0, 0, 0, 0, 0, 0, 0, 0, 0, 0, 0, 0, 0, 0, 0, 0, 0, 0, 0, 18, 5, 4, 13, 7, 9, 8, 7, 14, 4],
            [4, 4, 6, 5, 4, 6, 0, 0, 0, 0, 0, 0, 0, 0, 0, 0, 0, 0, 0, 0, 0, 0, 0, 0, 0, 0, 0, 0, 0, 0, 0, 0, 0, 0, 0, 0, 0, 0, 0, 0, 0, 0, 0, 0, 0, 0, 0, 0, 0, 0, 18, 5, 4, 4, 4, 6, 5, 4, 4, 4],
            [4, 4, 6, 5, 4, 13, 7, 7, 7, 7, 9, 8, 7, 7, 7, 7, 9, 0, 0, 0, 0, 0, 0, 0, 0, 0, 0, 0, 0, 0, 0, 0, 0, 0, 0, 0, 0, 0, 0, 0, 8, 7, 7, 7, 7, 9, 8, 7, 7, 7, 7, 14, 4, 4, 4, 6, 5, 4, 4, 4],
            [4, 4, 6, 5, 4, 4, 4, 4, 4, 4, 6, 5, 4, 4, 4, 4, 6, 20, 20, 20, 20, 20, 20, 20, 20, 20, 20, 20, 20, 20, 20, 20, 20, 20, 20, 20, 20, 20, 20, 20, 5, 4, 4, 4, 4, 6, 5, 4, 4, 4, 4, 4, 4, 4, 4, 6, 5, 4, 4, 4],
            [4, 4, 6, 5, 4, 4, 4, 4, 4, 4, 6, 5, 4, 4, 4, 4, 13, 7, 7, 7, 7, 7, 7, 7, 7, 9, 8, 7, 7, 7, 7, 9, 8, 7, 7, 7, 7, 7, 7, 7, 14, 4, 4, 4, 4, 6, 5, 4, 4, 4, 4, 4, 4, 4, 4, 6, 5, 4, 4, 4],
            [4, 4, 6, 5, 4, 4, 4, 4, 4, 4, 6, 5, 4, 4, 4, 4, 4, 4, 4, 4, 4, 4, 4, 4, 4, 6, 5, 4, 4, 4, 4, 6, 5, 4, 4, 4, 4, 4, 4, 4, 4, 4, 4, 4, 4, 6, 5, 4, 4, 4, 4, 4, 4, 4, 4, 6, 5, 4, 4, 4],
            [1, 1, 3, 2, 1, 1, 1, 1, 1, 1, 3, 2, 1, 1, 1, 1, 1, 1, 1, 1, 1, 1, 1, 1, 1, 3, 2, 1, 1, 1, 1, 3, 2, 1, 1, 1, 1, 1, 1, 1, 1, 1, 1, 1, 1, 3, 2, 1, 1, 1, 1, 1, 1, 1, 1, 3, 2, 1, 1, 1],
            [7, 7, 9, 8, 7, 7, 7, 7, 7, 7, 9, 8, 7, 7, 7, 7, 7, 7, 7, 7, 7, 7, 7, 7, 7, 9, 8, 7, 7, 7, 7, 9, 8, 7, 7, 7, 7, 7, 7, 7, 7, 7, 7, 7, 7, 9, 8, 7, 7, 7, 7, 7, 7, 7, 7, 9, 8, 7, 7, 7],
            [4, 4, 6, 5, 4, 4, 4, 4, 4, 4, 6, 5, 4, 4, 4, 4, 4, 4, 4, 4, 4, 4, 4, 4, 4, 6, 5, 4, 4, 4, 4, 6, 5, 4, 4, 4, 4, 4, 4, 4, 4, 4, 4, 4, 4, 6, 5, 4, 4, 4, 4, 4, 4, 4, 4, 6, 5, 4, 4, 4]
        ],
        "Entities": [
            {
                "$type": "Pxl.Snake, Pxl",
                "Bounds": { "x": 332.0, "y": 347.0, "width": 28.0, "height": 15.0},
                "Direction": -1.0,
                "LeftRange": {"X": 320, "Y": 395},
                "RightRange": {"X": 416, "Y": 395}
            }
        ],
        "SpawnPoint": {"X": 32, "Y": 348}
    },
    {
        "Stage": 0,
        "Id": 1,
        "Size": { "Width": 960, "Height": 540 },
        "StationaryMap": [
            [4, 4, 4, 4, 4, 4, 4, 4, 4, 4, 4, 4, 4, 4, 4, 4, 4, 4, 6, 5, 4, 4, 4, 4, 4, 4, 4, 4, 4, 4, 4, 4, 4, 4, 4, 6, 5, 4, 4, 4, 4, 4, 4, 4, 4, 4, 4, 4, 4, 4, 4, 4, 6, 5, 4, 4, 4, 4, 4, 4],
            [1, 1, 1, 1, 1, 1, 1, 1, 1, 16, 4, 4, 4, 4, 4, 4, 4, 4, 6, 5, 4, 4, 4, 4, 4, 4, 4, 4, 4, 4, 4, 4, 4, 4, 4, 6, 2, 1, 1, 1, 1, 1, 1, 1, 1, 1, 1, 1, 1, 1, 1, 1, 3, 5, 4, 4, 4, 4, 4, 4],
            [0, 0, 0, 0, 0, 0, 0, 0, 0, 5, 4, 4, 4, 4, 4, 4, 4, 4, 6, 2, 1, 1, 1, 1, 1, 1, 1, 1, 1, 1, 1, 1, 1, 1, 1, 3, 8, 7, 7, 7, 7, 7, 7, 7, 7, 7, 7, 7, 7, 7, 7, 7, 9, 5, 4, 4, 4, 4, 4, 4],
            [0, 0, 0, 0, 0, 0, 0, 0, 0, 2, 1, 1, 1, 1, 16, 4, 4, 4, 6, 8, 7, 7, 7, 7, 7, 7, 7, 7, 7, 7, 7, 7, 7, 7, 7, 9, 5, 4, 4, 4, 4, 4, 4, 15, 1, 1, 1, 1, 1, 1, 1, 1, 3, 2, 1, 1, 1, 1, 1, 1],
            [0, 0, 0, 0, 0, 0, 0, 0, 0, 0, 0, 0, 0, 0, 5, 4, 4, 4, 6, 5, 4, 4, 4, 4, 4, 4, 4, 4, 4, 4, 4, 4, 4, 4, 4, 6, 5, 4, 4, 4, 4, 4, 4, 6, 0, 0, 0, 0, 0, 0, 0, 0, 0, 0, 0, 0, 0, 0, 0, 0],
            [0, 0, 0, 0, 0, 0, 0, 0, 0, 0, 0, 0, 0, 0, 5, 4, 4, 4, 6, 5, 4, 4, 4, 4, 4, 4, 4, 4, 15, 1, 1, 1, 1, 1, 1, 3, 2, 1, 1, 1, 1, 1, 1, 3, 0, 0, 0, 0, 0, 0, 0, 0, 0, 0, 0, 0, 0, 0, 0, 0],
            [0, 0, 0, 0, 0, 0, 0, 0, 0, 0, 0, 0, 0, 0, 2, 1, 1, 1, 3, 2, 1, 1, 1, 1, 1, 1, 1, 1, 3, 0, 0, 0, 0, 0, 0, 0, 0, 0, 0, 0, 0, 0, 0, 0, 0, 0, 0, 0, 0, 0, 0, 0, 0, 0, 0, 0, 0, 0, 0, 0],
            [0, 0, 0, 0, 0, 0, 0, 0, 0, 0, 0, 0, 0, 0, 8, 7, 7, 7, 9, 8, 7, 7, 7, 7, 7, 7, 7, 7, 9, 0, 0, 0, 0, 0, 0, 0, 0, 0, 0, 0, 0, 0, 0, 0, 0, 0, 0, 0, 0, 0, 0, 0, 0, 0, 0, 0, 0, 0, 0, 0],
            [0, 0, 0, 0, 0, 0, 0, 0, 0, 0, 0, 0, 0, 0, 5, 4, 4, 4, 6, 5, 4, 4, 4, 4, 15, 1, 1, 1, 3, 0, 0, 0, 0, 0, 0, 0, 0, 0, 0, 0, 0, 0, 0, 0, 0, 0, 0, 0, 0, 0, 0, 0, 0, 0, 0, 0, 0, 0, 0, 0],
            [0, 0, 0, 0, 0, 0, 0, 0, 0, 0, 0, 0, 0, 0, 5, 4, 4, 4, 6, 5, 4, 4, 4, 4, 6, 0, 0, 0, 0, 0, 0, 0, 0, 0, 0, 0, 0, 0, 0, 0, 0, 0, 0, 0, 0, 0, 0, 0, 0, 0, 0, 0, 0, 0, 0, 0, 0, 0, 0, 0],
            [0, 0, 0, 0, 0, 0, 0, 0, 0, 0, 0, 0, 0, 0, 5, 4, 4, 4, 6, 5, 4, 4, 4, 4, 6, 0, 0, 0, 0, 0, 0, 0, 0, 0, 0, 0, 0, 0, 0, 0, 0, 0, 0, 0, 0, 0, 0, 0, 0, 0, 0, 0, 0, 0, 0, 0, 0, 0, 0, 0],
            [0, 0, 0, 0, 0, 0, 0, 0, 0, 0, 0, 0, 0, 0, 2, 1, 16, 4, 6, 5, 4, 4, 4, 4, 6, 0, 0, 0, 0, 0, 0, 0, 0, 0, 0, 0, 0, 0, 0, 0, 0, 0, 0, 0, 0, 0, 0, 0, 0, 0, 0, 0, 0, 0, 0, 0, 0, 0, 0, 0],
            [0, 0, 0, 0, 0, 0, 0, 0, 0, 0, 0, 0, 0, 0, 0, 0, 5, 4, 6, 5, 4, 4, 15, 1, 3, 0, 0, 0, 0, 0, 0, 0, 0, 11, 10, 10, 10, 10, 10, 10, 10, 10, 0, 0, 0, 0, 0, 0, 0, 0, 0, 0, 0, 0, 0, 0, 0, 0, 0, 0],
            [7, 7, 9, 8, 7, 7, 9, 0, 0, 0, 0, 0, 0, 0, 0, 0, 5, 4, 6, 5, 4, 4, 6, 0, 0, 0, 0, 0, 0, 0, 0, 0, 0, 0, 0, 0, 0, 0, 0, 0, 0, 0, 0, 0, 0, 0, 0, 0, 0, 0, 0, 0, 0, 0, 0, 0, 0, 0, 0, 0],
            [4, 4, 6, 5, 4, 4, 6, 0, 0, 0, 0, 0, 0, 0, 0, 0, 2, 1, 3, 2, 1, 1, 3, 0, 0, 0, 0, 0, 0, 0, 0, 0, 0, 0, 0, 0, 0, 0, 0, 0, 0, 0, 0, 0, 0, 0, 0, 0, 0, 0, 0, 0, 0, 0, 0, 0, 0, 0, 0, 0],
            [4, 4, 6, 5, 4, 4, 6, 0, 0, 0, 0, 0, 0, 0, 0, 0, 8, 7, 9, 8, 7, 7, 9, 0, 0, 0, 0, 0, 0, 0, 0, 0, 0, 0, 0, 0, 0, 0, 0, 0, 0, 0, 0, 0, 18, 8, 7, 7, 7, 9, 8, 7, 7, 7, 7, 9, 8, 7, 7, 7],
            [4, 4, 6, 5, 4, 4, 6, 0, 0, 0, 0, 0, 0, 0, 0, 0, 5, 4, 6, 5, 4, 4, 6, 0, 0, 0, 0, 0, 0, 0, 0, 0, 0, 0, 0, 0, 0, 0, 0, 0, 0, 0, 0, 0, 18, 5, 4, 4, 4, 6, 5, 4, 4, 4, 4, 6, 5, 4, 4, 4],
            [4, 4, 6, 5, 4, 4, 6, 0, 0, 0, 0, 0, 0, 0, 0, 0, 2, 1, 3, 2, 1, 1, 3, 0, 0, 0, 0, 11, 10, 10, 10, 12, 0, 0, 0, 0, 0, 0, 0, 0, 0, 0, 0, 0, 18, 5, 4, 4, 4, 6, 5, 4, 4, 4, 4, 6, 5, 4, 4, 4],
            [4, 4, 6, 5, 4, 4, 6, 0, 0, 0, 0, 0, 0, 0, 0, 0, 0, 0, 0, 0, 0, 0, 0, 0, 0, 0, 0, 0, 0, 0, 0, 0, 0, 0, 0, 0, 0, 20, 20, 0, 0, 0, 0, 0, 18, 5, 4, 4, 4, 6, 5, 4, 4, 4, 4, 6, 5, 4, 4, 4],
            [4, 4, 6, 5, 4, 4, 6, 0, 0, 0, 0, 0, 0, 0, 0, 0, 0, 0, 0, 0, 0, 0, 0, 0, 0, 0, 0, 0, 0, 0, 0, 0, 0, 0, 0, 0, 11, 10, 10, 12, 0, 0, 0, 0, 18, 5, 4, 4, 4, 6, 5, 4, 4, 4, 4, 6, 5, 4, 4, 4],
            [4, 4, 6, 5, 4, 4, 6, 0, 0, 0, 0, 0, 0, 0, 0, 0, 0, 0, 0, 0, 0, 0, 0, 0, 0, 0, 0, 0, 0, 0, 0, 0, 0, 0, 0, 0, 0, 0, 0, 0, 0, 0, 0, 0, 18, 5, 4, 4, 4, 6, 2, 1, 1, 1, 1, 3, 5, 4, 4, 4],
            [4, 4, 6, 5, 4, 4, 6, 0, 0, 0, 0, 0, 0, 0, 0, 0, 0, 0, 0, 0, 0, 0, 0, 0, 0, 0, 0, 0, 0, 0, 0, 0, 0, 0, 0, 0, 0, 0, 0, 0, 0, 0, 0, 0, 18, 5, 4, 4, 4, 6, 8, 7, 7, 7, 7, 9, 5, 4, 4, 4],
            [4, 4, 6, 2, 1, 1, 3, 0, 0, 0, 0, 0, 0, 0, 0, 0, 0, 0, 0, 0, 0, 0, 0, 0, 0, 0, 0, 0, 0, 0, 0, 0, 0, 0, 0, 0, 0, 0, 0, 0, 0, 0, 0, 0, 18, 5, 4, 4, 4, 6, 5, 4, 4, 4, 4, 6, 5, 4, 4, 4],
            [4, 4, 6, 8, 7, 7, 9, 0, 0, 0, 0, 0, 0, 0, 0, 0, 0, 0, 0, 0, 0, 0, 0, 0, 0, 0, 0, 0, 0, 0, 0, 0, 0, 0, 0, 0, 0, 0, 0, 0, 0, 8, 7, 7, 7, 14, 4, 4, 4, 6, 5, 4, 4, 4, 4, 6, 5, 4, 4, 4],
            [4, 4, 6, 5, 4, 4, 6, 0, 0, 0, 0, 0, 0, 0, 0, 0, 0, 0, 0, 0, 0, 0, 0, 0, 0, 0, 0, 0, 0, 0, 0, 0, 0, 0, 0, 0, 0, 0, 0, 0, 0, 5, 4, 4, 4, 4, 4, 4, 4, 6, 2, 1, 1, 1, 1, 3, 5, 4, 4, 4],
            [4, 4, 6, 5, 4, 4, 6, 0, 0, 0, 0, 0, 0, 0, 0, 0, 0, 0, 0, 0, 0, 0, 0, 0, 0, 0, 0, 0, 0, 0, 0, 0, 0, 0, 0, 0, 0, 0, 0, 0, 0, 5, 4, 4, 4, 4, 4, 4, 4, 6, 8, 7, 7, 7, 7, 9, 5, 4, 4, 4],
            [4, 4, 6, 5, 4, 4, 6, 0, 0, 0, 0, 0, 0, 0, 0, 0, 0, 0, 0, 0, 0, 0, 0, 0, 0, 0, 0, 0, 0, 0, 0, 0, 0, 0, 0, 0, 0, 0, 0, 0, 0, 5, 4, 4, 4, 4, 4, 4, 4, 6, 5, 4, 4, 4, 4, 6, 5, 4, 4, 4],
            [4, 4, 6, 5, 4, 4, 13, 7, 7, 9, 0, 0, 0, 0, 0, 11, 10, 10, 10, 10, 12, 0, 0, 0, 0, 0, 8, 7, 7, 7, 7, 7, 7, 9, 8, 7, 7, 7, 7, 7, 7, 14, 4, 4, 4, 4, 4, 4, 4, 6, 5, 4, 4, 4, 4, 6, 2, 1, 1, 1],
            [4, 4, 6, 5, 4, 4, 4, 4, 4, 6, 0, 0, 0, 0, 0, 0, 0, 0, 0, 0, 0, 0, 0, 0, 0, 0, 5, 4, 4, 4, 4, 4, 4, 6, 5, 4, 4, 4, 4, 4, 4, 4, 4, 4, 4, 4, 4, 4, 4, 6, 5, 4, 4, 4, 4, 6, 8, 7, 7, 7],
            [1, 1, 3, 5, 4, 4, 4, 4, 4, 6, 0, 0, 0, 0, 0, 0, 0, 0, 0, 0, 0, 0, 0, 0, 0, 0, 5, 4, 4, 4, 4, 4, 4, 6, 5, 4, 4, 4, 4, 4, 4, 4, 4, 4, 4, 4, 4, 4, 4, 6, 5, 4, 4, 4, 4, 6, 5, 4, 4, 4],
            [7, 7, 9, 5, 4, 4, 4, 4, 4, 6, 20, 20, 20, 20, 20, 20, 20, 20, 20, 20, 20, 20, 20, 20, 20, 20, 5, 4, 4, 4, 4, 4, 4, 6, 2, 1, 1, 1, 1, 1, 1, 1, 1, 1, 1, 1, 1, 1, 1, 3, 5, 4, 4, 4, 4, 6, 5, 4, 4, 4],
            [4, 4, 6, 5, 4, 4, 4, 4, 4, 13, 7, 9, 8, 7, 7, 7, 7, 9, 8, 7, 7, 7, 7, 9, 8, 7, 14, 4, 4, 4, 4, 4, 4, 6, 8, 7, 7, 7, 7, 7, 7, 7, 7, 7, 7, 7, 7, 7, 7, 9, 5, 4, 4, 4, 4, 6, 5, 4, 4, 4],
            [4, 4, 6, 5, 4, 4, 4, 4, 4, 4, 4, 6, 5, 4, 4, 4, 4, 6, 5, 4, 4, 4, 4, 6, 5, 4, 4, 4, 4, 4, 4, 4, 4, 6, 5, 4, 4, 4, 4, 4, 4, 4, 4, 4, 4, 4, 4, 4, 4, 6, 5, 4, 4, 4, 4, 6, 5, 4, 4, 4],
            [4, 4, 6, 5, 4, 4, 4, 4, 4, 4, 4, 6, 5, 4, 4, 4, 4, 6, 5, 4, 4, 4, 4, 6, 5, 4, 4, 4, 4, 4, 4, 4, 4, 6, 5, 4, 4, 4, 4, 4, 4, 4, 4, 4, 4, 4, 4, 4, 4, 6, 5, 4, 4, 4, 4, 6, 5, 4, 4, 4]
    ],
        "Entities": [
            {
                "$type": "Pxl.Snake, Pxl",
                "Bounds": { "x": 300.0, "y": 401.0, "width": 28.0, "height": 15.0},
                "Direction": -1.0,
                "LeftRange": {"X": 256, "Y": 416},
                "RightRange": {"X": 320, "Y": 416}
            },
            {
                "$type": "Pxl.Mushroom, Pxl",
                "Bounds": { "x": 500.0, "y": 373.0, "width": 26.0, "height": 43.0},
                "Direction": -1.0,
                "LeftRange": {"X": 432, "Y": 416},
                "RightRange": null
            }
        ],
        "SpawnPoint": {"X": 32, "Y": 172}
    },
    {
        "Stage": 0,
        "Id": 2,
        "Size": { "Width": 960, "Height": 540 },
        "StationaryMap": [
            [4, 4, 4, 6, 5, 4, 4, 4, 4, 6, 2, 1, 1, 1, 1, 1, 1, 3, 5, 4, 4, 4, 4, 4, 4, 4, 4, 4, 6, 5, 4, 4, 4, 4, 4, 4, 4, 6, 8, 7, 7, 7, 7, 7, 7, 9, 5, 4, 4, 4, 4, 4, 4, 4, 4, 4, 6, 2, 1, 1],
            [1, 1, 1, 3, 5, 4, 4, 4, 4, 6, 8, 7, 7, 7, 7, 7, 7, 9, 5, 4, 4, 4, 4, 4, 4, 4, 4, 4, 6, 5, 4, 4, 4, 4, 4, 4, 4, 6, 5, 4, 4, 4, 4, 4, 4, 6, 5, 4, 4, 4, 4, 4, 4, 4, 4, 4, 6, 8, 7, 7],
            [7, 7, 7, 9, 5, 4, 4, 4, 4, 6, 5, 4, 4, 4, 4, 4, 4, 6, 5, 4, 15, 1, 1, 1, 1, 1, 1, 1, 3, 2, 1, 1, 1, 1, 1, 1, 1, 3, 2, 1, 1, 1, 1, 1, 1, 3, 2, 1, 1, 1, 1, 1, 1, 1, 16, 4, 6, 5, 4, 4],
            [4, 4, 4, 6, 5, 4, 4, 4, 4, 6, 5, 4, 4, 4, 4, 15, 1, 3, 2, 1, 3, 0, 0, 0, 0, 0, 0, 0, 0, 0, 0, 0, 0, 0, 0, 0, 0, 0, 0, 0, 0, 0, 0, 0, 0, 0, 0, 0, 0, 0, 0, 0, 0, 0, 2, 1, 3, 2, 1, 16],
            [4, 4, 4, 6, 5, 4, 4, 4, 4, 6, 5, 4, 4, 4, 4, 6, 0, 0, 0, 0, 0, 0, 0, 0, 0, 0, 0, 0, 0, 0, 0, 0, 0, 0, 0, 0, 0, 0, 0, 0, 0, 0, 0, 0, 0, 0, 0, 0, 0, 0, 0, 0, 0, 0, 0, 0, 0, 0, 0, 5],
            [1, 1, 1, 3, 2, 1, 1, 1, 1, 3, 2, 1, 1, 16, 4, 6, 0, 0, 0, 0, 0, 0, 0, 0, 0, 0, 0, 0, 0, 0, 0, 0, 0, 0, 0, 0, 0, 0, 0, 0, 0, 0, 0, 0, 0, 0, 0, 0, 0, 0, 0, 0, 0, 0, 0, 0, 0, 0, 0, 5],
            [0, 0, 0, 0, 0, 0, 0, 0, 0, 0, 0, 0, 0, 5, 4, 6, 0, 0, 0, 0, 0, 0, 0, 0, 0, 0, 0, 0, 0, 0, 0, 0, 0, 0, 0, 0, 0, 0, 0, 0, 0, 0, 0, 0, 0, 0, 0, 0, 0, 0, 0, 0, 0, 0, 0, 0, 0, 0, 0, 5],
            [0, 0, 0, 0, 0, 0, 0, 0, 0, 0, 0, 0, 0, 5, 4, 6, 0, 0, 0, 0, 0, 0, 0, 0, 11, 10, 10, 12, 0, 0, 0, 0, 11, 10, 10, 12, 0, 0, 0, 0, 0, 11, 10, 10, 10, 12, 8, 7, 7, 9, 11, 10, 12, 0, 0, 0, 0, 0, 0, 5],
            [11, 10, 10, 10, 10, 10, 10, 10, 10, 10, 10, 10, 12, 5, 4, 6, 0, 0, 0, 0, 0, 0, 0, 0, 0, 0, 0, 0, 0, 0, 0, 0, 0, 0, 0, 0, 0, 0, 0, 0, 0, 0, 0, 0, 0, 0, 5, 4, 4, 6, 0, 0, 0, 0, 0, 0, 0, 0, 0, 5],
            [0, 0, 0, 0, 0, 0, 0, 0, 0, 0, 0, 0, 0, 2, 1, 3, 0, 0, 0, 0, 0, 0, 0, 0, 0, 0, 0, 0, 0, 0, 0, 0, 0, 0, 0, 0, 0, 0, 0, 0, 0, 0, 0, 0, 0, 0, 2, 1, 1, 3, 0, 0, 0, 0, 0, 0, 0, 0, 0, 5],
            [0, 0, 0, 0, 0, 0, 0, 0, 0, 0, 0, 0, 0, 8, 7, 9, 11, 10, 12, 0, 0, 0, 0, 0, 0, 0, 0, 0, 0, 0, 0, 0, 0, 0, 0, 0, 0, 0, 0, 0, 0, 0, 0, 0, 0, 0, 8, 7, 7, 9, 0, 0, 0, 0, 0, 0, 0, 0, 0, 5],
            [0, 0, 0, 0, 0, 0, 0, 0, 0, 0, 0, 0, 0, 5, 4, 6, 0, 0, 0, 0, 0, 0, 0, 0, 0, 0, 0, 0, 0, 0, 0, 0, 0, 0, 0, 0, 0, 0, 0, 0, 0, 0, 0, 0, 0, 18, 5, 4, 4, 6, 0, 0, 0, 0, 0, 0, 0, 0, 0, 5],
            [0, 0, 0, 0, 0, 0, 0, 0, 0, 0, 0, 0, 0, 5, 4, 6, 0, 0, 0, 0, 0, 0, 0, 0, 0, 0, 0, 0, 0, 0, 0, 0, 0, 0, 0, 0, 0, 0, 0, 0, 0, 0, 0, 0, 0, 18, 5, 4, 4, 6, 0, 0, 0, 0, 0, 20, 0, 0, 0, 5],
            [0, 0, 0, 0, 0, 0, 0, 0, 0, 0, 0, 0, 0, 5, 4, 6, 0, 0, 0, 0, 0, 0, 0, 0, 0, 0, 0, 0, 0, 0, 0, 0, 0, 0, 0, 0, 0, 0, 0, 0, 0, 0, 0, 0, 0, 18, 5, 4, 4, 6, 0, 0, 0, 0, 0, 11, 10, 10, 10, 12],
            [0, 0, 0, 0, 0, 0, 0, 0, 0, 0, 0, 0, 0, 2, 1, 3, 0, 0, 0, 0, 0, 11, 10, 10, 10, 10, 10, 10, 10, 10, 10, 10, 10, 10, 10, 10, 10, 10, 10, 10, 12, 0, 0, 0, 0, 18, 5, 4, 4, 6, 0, 0, 0, 0, 0, 0, 0, 0, 0, 0],
            [7, 9, 8, 7, 9, 11, 12, 0, 0, 0, 0, 0, 0, 8, 7, 9, 0, 0, 0, 0, 0, 0, 0, 0, 0, 0, 0, 0, 0, 0, 0, 0, 0, 0, 0, 0, 0, 0, 0, 0, 0, 0, 0, 0, 0, 18, 5, 4, 4, 6, 0, 0, 0, 0, 0, 0, 0, 0, 0, 0],
            [4, 6, 5, 4, 6, 0, 0, 0, 0, 0, 0, 0, 0, 5, 4, 6, 0, 0, 0, 0, 0, 0, 0, 0, 0, 0, 0, 0, 0, 0, 0, 0, 0, 0, 0, 0, 0, 0, 0, 0, 0, 0, 0, 0, 0, 18, 5, 4, 4, 6, 0, 0, 0, 0, 0, 0, 0, 0, 0, 0],
            [4, 6, 5, 4, 6, 0, 0, 0, 0, 0, 0, 0, 0, 5, 4, 6, 0, 0, 0, 0, 0, 0, 0, 0, 0, 0, 0, 0, 0, 0, 0, 0, 0, 0, 0, 0, 0, 0, 0, 0, 0, 0, 0, 11, 10, 12, 5, 4, 4, 6, 0, 0, 0, 20, 0, 0, 0, 0, 0, 0],
            [4, 6, 5, 4, 6, 0, 0, 0, 0, 0, 0, 0, 0, 5, 4, 6, 0, 0, 0, 0, 0, 0, 0, 0, 0, 0, 0, 0, 0, 0, 0, 0, 0, 0, 0, 0, 0, 0, 0, 0, 0, 0, 0, 0, 0, 0, 5, 4, 4, 6, 0, 0, 11, 12, 0, 0, 0, 0, 0, 0],
            [4, 6, 5, 4, 6, 0, 0, 11, 10, 12, 0, 0, 0, 2, 1, 3, 0, 0, 0, 0, 0, 0, 0, 0, 0, 0, 0, 0, 0, 0, 0, 0, 0, 0, 0, 0, 0, 0, 0, 0, 0, 0, 0, 0, 0, 0, 5, 4, 4, 6, 0, 0, 0, 0, 0, 0, 0, 0, 0, 0],
            [4, 6, 5, 4, 6, 0, 0, 0, 0, 0, 0, 0, 0, 0, 0, 0, 0, 0, 0, 0, 0, 0, 0, 0, 0, 0, 0, 0, 0, 0, 0, 0, 0, 0, 0, 0, 0, 0, 0, 0, 0, 0, 0, 0, 0, 0, 5, 4, 4, 6, 0, 0, 0, 0, 0, 0, 0, 0, 0, 0],
            [4, 6, 5, 4, 6, 0, 0, 0, 0, 0, 0, 0, 0, 0, 0, 0, 0, 0, 0, 0, 0, 11, 10, 10, 10, 10, 10, 10, 10, 10, 10, 10, 10, 10, 10, 10, 10, 10, 10, 10, 12, 0, 0, 0, 0, 0, 5, 4, 4, 6, 0, 0, 0, 0, 0, 0, 0, 0, 0, 0],
            [1, 3, 5, 4, 6, 0, 0, 0, 0, 0, 0, 0, 0, 0, 0, 0, 0, 0, 0, 0, 0, 0, 0, 0, 0, 0, 0, 0, 0, 0, 0, 0, 0, 0, 0, 0, 0, 0, 0, 0, 0, 0, 0, 0, 0, 0, 2, 1, 1, 3, 0, 0, 0, 0, 0, 0, 0, 0, 0, 0],
            [7, 9, 5, 4, 6, 0, 0, 0, 0, 0, 0, 0, 0, 11, 10, 12, 0, 0, 0, 0, 0, 0, 0, 0, 0, 0, 0, 0, 0, 0, 0, 0, 0, 0, 0, 0, 0, 0, 0, 0, 0, 0, 0, 0, 0, 0, 8, 7, 7, 9, 20, 20, 20, 20, 20, 20, 0, 0, 0, 0],
            [4, 6, 5, 4, 6, 0, 0, 0, 0, 0, 0, 0, 0, 0, 0, 0, 0, 0, 0, 0, 0, 0, 0, 0, 0, 0, 0, 0, 0, 0, 0, 0, 0, 0, 0, 0, 0, 0, 0, 0, 0, 0, 0, 0, 0, 0, 5, 4, 4, 13, 7, 7, 7, 7, 9, 8, 7, 7, 7, 7],
            [4, 6, 5, 4, 6, 20, 20, 0, 0, 0, 0, 0, 0, 0, 0, 0, 0, 0, 0, 0, 0, 0, 0, 0, 0, 0, 0, 0, 0, 0, 0, 0, 0, 0, 0, 0, 0, 0, 0, 0, 0, 0, 0, 0, 0, 0, 5, 4, 4, 4, 4, 4, 4, 4, 6, 5, 4, 4, 4, 4],
            [4, 6, 5, 4, 13, 7, 9, 20, 20, 0, 0, 0, 0, 0, 20, 20, 20, 20, 20, 20, 20, 20, 20, 20, 20, 20, 20, 20, 20, 20, 20, 20, 20, 20, 20, 20, 20, 20, 20, 20, 20, 20, 20, 20, 20, 20, 5, 4, 4, 4, 4, 4, 4, 4, 6, 5, 4, 4, 4, 4],
            [4, 6, 5, 4, 4, 4, 13, 7, 9, 0, 0, 0, 0, 0, 8, 7, 7, 7, 7, 9, 8, 7, 7, 7, 7, 7, 9, 8, 7, 7, 7, 7, 7, 9, 8, 7, 7, 7, 7, 7, 9, 8, 7, 7, 7, 7, 14, 4, 4, 4, 4, 4, 4, 4, 6, 5, 4, 4, 4, 4],
            [4, 6, 5, 4, 4, 4, 4, 4, 6, 0, 0, 0, 0, 0, 5, 4, 4, 4, 4, 6, 5, 4, 4, 4, 4, 4, 6, 5, 4, 4, 4, 4, 4, 6, 5, 4, 4, 4, 4, 4, 6, 5, 4, 4, 4, 4, 4, 4, 4, 4, 4, 4, 4, 4, 6, 5, 4, 4, 4, 4],
            [4, 6, 2, 1, 1, 1, 1, 1, 3, 0, 0, 0, 0, 0, 5, 4, 4, 4, 4, 6, 5, 4, 4, 4, 4, 4, 6, 2, 1, 1, 1, 1, 1, 3, 5, 4, 4, 4, 4, 4, 6, 5, 4, 4, 4, 4, 4, 4, 4, 4, 4, 4, 4, 4, 6, 5, 4, 4, 4, 4],
            [4, 6, 8, 7, 7, 7, 7, 7, 9, 20, 20, 20, 20, 20, 5, 4, 4, 4, 4, 6, 5, 4, 4, 4, 4, 4, 6, 8, 7, 7, 7, 7, 7, 9, 5, 4, 4, 4, 4, 4, 6, 5, 4, 4, 4, 4, 4, 4, 4, 4, 4, 4, 4, 4, 6, 5, 4, 4, 4, 4],
            [4, 6, 5, 4, 4, 4, 4, 4, 13, 9, 8, 7, 9, 8, 14, 4, 4, 4, 4, 6, 5, 4, 4, 4, 4, 4, 6, 5, 4, 4, 4, 4, 4, 6, 2, 1, 1, 1, 1, 1, 3, 5, 4, 4, 4, 4, 4, 4, 4, 4, 4, 4, 4, 4, 6, 5, 4, 4, 4, 4],
            [4, 6, 5, 4, 4, 4, 4, 4, 4, 6, 5, 4, 6, 5, 4, 4, 4, 4, 4, 6, 2, 1, 1, 1, 1, 1, 3, 5, 4, 4, 4, 4, 4, 6, 8, 7, 7, 7, 7, 7, 9, 5, 4, 4, 4, 4, 4, 4, 4, 4, 4, 4, 4, 4, 6, 5, 4, 4, 4, 4],
            [4, 6, 5, 4, 4, 4, 4, 4, 4, 6, 5, 4, 6, 5, 4, 4, 4, 4, 4, 6, 8, 7, 7, 7, 7, 7, 9, 5, 4, 4, 4, 4, 4, 6, 5, 4, 4, 4, 4, 4, 6, 5, 4, 4, 4, 4, 4, 4, 4, 4, 4, 4, 4, 4, 6, 5, 4, 4, 4, 4]
    ],
        "Entities": [
            {
                "$type": "Pxl.Mushroom, Pxl",
                "Bounds": { "x": 400.0, "y": 277.0, "width": 26.0, "height": 43.0},
                "Direction": -1.0,
                "LeftRange": {"X": 336, "Y": 320},
                "RightRange": {"X": 640, "Y": 320}
            },
            {
                "$type": "Pxl.Mushroom, Pxl",
                "Bounds": { "x": 500.0, "y": 277.0, "width": 26.0, "height": 43.0},
                "Direction": -1.0,
                "LeftRange": {"X": 336, "Y": 320},
                "RightRange": {"X": 640, "Y": 320}
            },
            {
                "$type": "Pxl.Mushroom, Pxl",
                "Bounds": { "x": 600.0, "y": 277.0, "width": 26.0, "height": 43.0},
                "Direction": -1.0,
                "LeftRange": {"X": 336, "Y": 320},
                "RightRange": {"X": 640, "Y": 320}
            },
            {
                "$type": "Pxl.Mushroom, Pxl",
                "Bounds": { "x": 450.0, "y": 165.0, "width": 26.0, "height": 43.0},
                "Direction": -1.0,
                "LeftRange": {"X": 336, "Y": 208},
                "RightRange": {"X": 640, "Y": 208}
            },
            {
                "$type": "Pxl.Mushroom, Pxl",
                "Bounds": { "x": 550.0, "y": 165.0, "width": 26.0, "height": 43.0},
                "Direction": -1.0,
                "LeftRange": {"X": 336, "Y": 208},
                "RightRange": {"X": 640, "Y": 208}
            }
        ],
        "SpawnPoint": {"X": 32, "Y": 192}
    }
]